╭─A (20 x 3)───────╮╭─B (20 x 3)───────╮
│   Placeholder    ││   Placeholder    │
╰──────────────────╯╰──────────────────╯
╭─C (20 x 4)───────╮╭─D (20 x 4)───────╮
│   Placeholder    ││   Placeholder    │
│                  ││                  │
╰──────────────────╯╰──────────────────╯
╭─E (20 x 4)───────╮╭─F (20 x 4)───────╮
│   Placeholder    ││   Placeholder    │
│                  ││                  │
╰──────────────────╯╰──────────────────╯
╭─G (20 x 4)───────╮╭─H (20 x 4)───────╮
│   Placeholder    ││   Placeholder    │
│                  ││                  │
╰──────────────────╯╰──────────────────╯