╭─B (40 x 3)───────────────────────────╮
│             Placeholder              │
╰──────────────────────────────────────╯
╭─C (20 x 4)───────╮╭─D (20 x 4)───────╮
│   Placeholder    ││   Placeholder    │
│                  ││                  │
╰──────────────────╯╰──────────────────╯
╭─E (20 x 4)───────╮╭─F (20 x 4)───────╮
│   Placeholder    ││   Placeholder    │
│                  ││                  │
╰──────────────────╯╰──────────────────╯
╭─G (40 x 4)───────────────────────────╮
│             Placeholder              │
│                                      │
╰──────────────────────────────────────╯