╭─T1 (40 x 3)──────────────────────────╮
│             Placeholder              │
╰──────────────────────────────────────╯
╭─T2 (40 x 4)──────────────────────────╮
│             Placeholder              │
│                                      │
╰──────────────────────────────────────╯
╭─B1 (40 x 4)──────────────────────────╮
│             Placeholder              │
│                                      │
╰──────────────────────────────────────╯
╭─B2 (40 x 4)──────────────────────────╮
│             Placeholder              │
│                                      │
╰──────────────────────────────────────╯