╭─L1…────╮╭─L2…────╮╭─R1…────╮╭─R2…────╮
│        ││        ││        ││        │
│        ││        ││        ││        │
│        ││        ││        ││        │
│        ││        ││        ││        │
│        ││        ││        ││        │
│ Placeh ││ Placeh ││ Placeh ││ Placeh │
│ older  ││ older  ││ older  ││ older  │
│        ││        ││        ││        │
│        ││        ││        ││        │
│        ││        ││        ││        │
│        ││        ││        ││        │
│        ││        ││        ││        │
│        ││        ││        ││        │
╰────────╯╰────────╯╰────────╯╰────────╯