╭─T1 (40 x 7)──────────────────────────╮
│                                      │
│                                      │
│             Placeholder              │
│                                      │
│                                      │
╰──────────────────────────────────────╯
╭─T2 (40 x 8)──────────────────────────╮
│                                      │
│                                      │
│             Placeholder              │
│                                      │
│                                      │
│                                      │
╰──────────────────────────────────────╯