╔══════════════════════════════════════╗
║ Hello                                ║
║                                      ║
║                                      ║
║                                      ║
║                                      ║
║                                      ║
║                                      ║
║                                      ║
║                                      ║
║                                      ║
║                                      ║
║                                      ║
║                                      ║
╚══════════════════════════════════════╝