╭─40 x 15──────────────────────────────╮
│                                      │
│                                      │
│                                      │
│                                      │
│                                      │
│                                      │
│             Placeholder              │
│                                      │
│                                      │
│                                      │
│                                      │
│                                      │
│                                      │
╰──────────────────────────────────────╯