╭─Top (40 x 7)─────────────────────────╮
│                                      │
│                                      │
│             Placeholder              │
│                                      │
│                                      │
╰──────────────────────────────────────╯
╭─Bottom (40 x 8)──────────────────────╮
│                                      │
│                                      │
│             Placeholder              │
│                                      │
│                                      │
│                                      │
╰──────────────────────────────────────╯